Candy Land
11110000001110110111
11111000000000001111
11110011100011111111
11000001001001111100
11001000100011111101
11001111110111111000
11100110110111111011
11110011110111111111
10111001110111000111
10011100010111010001
11001111000000000101
11100110011111011101
11110111100110000001
11111100101110111111
01111100111110100111
00111111111110110111
00011111111110000111