Mansions & Managers
11111100011110001111
11110101111100100111
11111101111001110011
11011100010011111001
11111100000111111100
00000000000000000000
11111101111110110011
11111101111110001111
11101101111111101111
11111000111111100011
00000010001000111011
11111000100010000000
11111101111000111111
11110100001101111011
10111111101101111111
11111100001101011111
11111101111101111111