Planet Tronne
10111001111111111111
00111011111011100110
11111110111111100111
11100111111101111111
11100111111101111111
11111110101101111011
11101100011111110111
00111111110011111111
11111001011111111111
11110110011111100111
11111111101011100011
00000011101111100001
11011001000110000011
11011011101111101110
00000001111000111101
11011011110010111011
11011000111011110111