Tutorial Island
00000000110000000000
00000000111000010000
00000001011000111110
00000001111101111110
00000000110011111110
00011110110001010110
00011111111011111111
00011111111010010000
00011111111110010000
00011111111110010000
00000011011111111110
00000000000001110010
00000000000001111110
00100001110001111110
00110001110000000000
00000001110000000000
00000000000000000000